15 15
...?????????...
.#.#?#?#?#?#.#.
..???????????..
?#?#?#?#?#?#?#?
???????????????
?#?#?#?#?#?#?#?
??????.$.??????
?#?#?#$$$#?#?#?
??????.$.??????
?#?#?#?#?#?#?#?
???????????????
?#?#?#?#?#?#?#?
..???????????..
.#.#?#?#?#?#?#.
...?????????...
