9 9
.........
.#....#..
.........
.#.......
.....#...
.#.......
.........
.#....#..
.........
